10
10
WWWWGGGGGG
GGGSGWWWWG
GWWWWWGGGG
GGGGGWGWWW
GWGWWWGWGG
GWGWGWGGGW
GWGWWWWWGW
GWGGGGGWXG
GWWWWWWWGG
GGGGGGGGGG
